11111
1P001
111C1
1E001
1111E
