111111111111111111111111
100000000000000000000001
1C00001110001111110000C1
100001110000110000100001
100011000000000001100001
100011111000000110000001
100000011000000000000001
100000011000111111000001
100000000000000000000001
100000000000000000000001
100011111000000000000001
1P0000000000111111100001
100011110000000000000001
100000000000000000000001
100001111110000001110001
100000000001111000000001
100000000000000000000001
100011111111000000000001
100000000000000000000001
100000000000000111111001
100011111100000000000001
100000000000011111110001
1000011111110000000000E1
100000000000000000000001
111111111111111111111111
